110000000000000000000
111101011101011101110
010101000101000100010
010101111101111111110
010001000000010001000
011111111101011101010
010001010001010000010
010111011111111111010
010000000000000101010
011111110111110101110
000101010001000100000
011101010111011101110
010100010101010101000
010111010101010111110
010001000001000101010
010101011111110101010
000101010001000001000
010101111101110101010
010100010001000101010
011111110111110111110
000000000000000000010